#######
####...####
###.......#
##........#
#...@.....#
###.......#
###.......#
###......##
##......##
##.....##
########
