##################
####....##########
###.......########
##........########
#.........########
###....@..########
###.......########
###......#########
##......##########
##.....###########
##################
##################
##################
##################
##################