#######
####...####
###.......#
##........#
#.........#
###....@..#
###.......#
###......##
##......##
##.....##
########
