###########
####....###
###.......#
##........#
#.........#
###....@..#
###.......#
###......##
##......###
##.....####
###########
