##################
####....##########
###.......########
##........####...#
#..............+.#
###....@..####...#
###.......########
###......#########
##......##########
##.....###########
##################
##################
##################
##################
##################