######################
####....##############
###.......############
##........####....####
#..............+..####
###....@..........####
###.......####....####
###......#############
##......##############
##.....###############
######################
######################
######################
######################
######################